X X X X X X X X X X X X X X X X X X X X
X M O O O O X O O O O O O O O O O O N X
X O O O O O X O O O O O O O O O M O O X
X C O O O O X O O X X X X O O X O O O X
X O O O O O X O O X O O X O O X O O O X
X O O O O N X O O X O O X O X X X O O X
X O O 0 X X X O O X O O X O O O X O O X
X O O 0 O O O O O X O O X O O O X O O X
X O O O O O O O O X O O X O O X X O O X
X P O O O O O O O O O O X O O X N O O D
X O O O O O O O O O M O X O O X O O O X
X M O O O O O O O O O O X O O X O O O X
X O O O O O O O O O O O X O O X O O O X
X O O O O O O O O O O O X O O X O O 0 X
X O O O O O O O O O O C X O O X O O M X
X O O O O O N O O O O O X N O X K O O X
X X X X X X X X X X X X X X X X X X X X